0 00 0 00 0 00 0 00 0 00 0 00 0 00 0 00 0 00 X XX X XX X XX X XX X

0 00 0 00 0 00 0 00 0 00 0 00 X XX X XX X XX X 00 F 00 F 00 F 00 E
0 00 0 00 0 00 X XX X XX X XX X 00 0 00 F 00 F 00 0 00 0 00 0 00 E

X XX X XX X XX X 00 F 00 F 00 F 00 F 00 0 00 0 00 X XX X XX X XX X

X 00 F 00 F 00 F 00 0 00 0 00 0 00 0 00 X XX X XX X XX X XX X 0B X
X 00 0 00 0 00 0 00 X XX X XX X XX X 00 X XX X XX X XX X XX X 00 X

X F0 X XX X XX X XX X XX X XX X XX X 00 F 00 F 00 F 00 X XX X 00 X

X 00 F 00 F 00 F 00 X XX X XX X XX X 00 0 00 0 00 0 00 F 00 F 00 X
X 00 0 00 0 00 0 00 F 00 F 00 F 00 X XX X XX X XX X 00 0 00 0 00 X

X XX X XX X XX X 00 0 00 0 00 0 00 F 00 F 00 F 00 X XX X XX X XX X

0 00 0 00 0 00 X XX X XX X XX X 00 0 00 0 00 0 00 F 00 F 00 F 00 X
0 00 0 00 0 00 0 00 0 00 0 00 X XX X XX X XX X 00 0 00 0 00 0 00 X

0 00 0 00 0 00 0 00 0 00 0 00 0 00 0 00 0 00 X XX X XX X XX X 00 X

0 00 0 00 0 00 0 00 0 00 0 00 X XX X XX X XX X 00 F 00 F 00 F 00 X
0 00 0 00 0 00 X XX X XX X XX X 00 F 00 F 00 F 00 0 00 0 00 0 00 X

X XX X XX X XX X 00 F 00 F 00 F 00 0 00 0 00 0 00 X XX X XX X XX X
X 00 F 00 F 00 F 00 0 00 0 00 0 00 X XX X XX X XX X XX X XX X XX X

X 00 0 00 0 00 0 00 X XX X XX X XX X 00 0 00 F 00 F 00 F 00 F 00 X
X F0 X XX X XX X XX X 00 F 00 F 00 F 00 F 00 0 00 0 00 0 00 0 00 X




X 00 X XX X XX X XX X 00 0 00 0 00 0 00 0 00 X XX X XX X XX X 00 X

e 00 F 00 F 00 F 00 F 00 X XX X XX X XX X 00 F 00 F 00 F 00 F 00 X
e 00 0 00 0 00 0 00 0 00 X 00 0 00 0 00 X 00 0 00 0 00 0 00 0 00 X

X XX X XX X XX X XX X XX X 00 0 00 0 00 X XX X XX X XX X XX X XX X