X XX X XX X XX X XX X XX X XX X XX X XX X XX X XX X XX X XX X XX X

X 0F 0 0F 0 0F 0 0F 0 0F 0 0F X 0F X 0F 0 0F 0 0F 0 0F 0 0F 0 0F X
X 00 0 00 0 00 0 00 0 00 0 00 X 00 X 00 0 00 0 00 0 00 0 00 0 00 X

X 00 X XX X XX X XX X XX X 00 X 00 X 00 X 00 X 00 X 00 X XX X 00 X

X 0F X 0F 0 0F 0 0F 0 0F X 0F 0 0F 0 0F X 0F X 0F X 0F 0 0F 0 0B X
X 00 X 00 0 00 0 00 0 00 X 00 0 00 0 00 X 00 X 00 X 00 0 00 0 00 X

X 00 X 00 X XX X XX X 00 X 00 X XX X XX X 00 X 00 X XX X XX X XX X

X 0F X 0F 0 0F 0 0F X 0F 0 0F 0 0F 0 0F X 0F X 0F 0 0F 0 0F 0 0F E
X 00 X 00 0 00 0 00 X 00 0 00 0 00 0 00 X 00 X 00 0 00 0 00 0 00 E

e 00 X XX X XX X 00 X 00 X XX X XX X 00 X 00 X 00 X XX X 00 X 00 X

e 00 X 0F 0 0F 0 0F X 0F X 0F 0 0F 0 0F 0 0F X 0F 0 0F X 0F X 0F X
X 00 X 00 0 00 0 00 X 00 X 00 0 00 0 00 0 00 X 00 0 00 X 00 X 00 X

X 00 X 00 X XX X XX X 00 X 00 X XX X XX X 00 X 00 X 00 X 00 X 00 X

X 0F X 0F 0 0F 0 0F 0 0F X 0F X 0F 0 0F 0 0F 0 0F X 0F 0 0F X 0F X
X 00 X 00 0 00 0 00 0 00 X 00 X 00 0 00 0 00 0 00 X 00 0 00 X 00 X

X 00 X XX X XX X XX X XX X 00 X 00 X 00 X XX X XX X XX X XX X 00 X

X 0F 0 0F 0 0F 0 0F 0 0F 0 0F X 0F X 0F 0 0F 0 0F 0 0F 0 0F 0 0F X
X 00 0 00 0 00 0 00 0 00 0 00 X 00 X 00 0 00 0 00 0 00 0 00 0 00 X

X XX X XX X XX X XX X XX X XX X XX X XX X XX X XX X XX X XX X XX X